1111111111111111111111111111111111
1E1000000100000C000000000000000001
1010C1110001110C1010000CC00CC00001
1C1111C11111C101111100C00CC00C0001
100000010000010C101000C000000C0001
111000010111110C000000C000000C0001
10100101001000001110010C0000C10101
101001001010111110100100C00C011111
1P0000000C00C000000000000CC10000E1
1111111111111111111111111111111111
