1111111111111
100100C000011
1000011111001
1P0011E000C01
1111111111111
